R          700     405
NO          ./pics/redbrick.xpm


SO ./pics/wood.xpm
WE   ./pics/barrel.xpm
EA   ./pics/gachi1.xpm
S ./pics/barrel.xpm
F         53      ,        97    ,     136
C 47      ,  191 ,  196

1
        11111111111111111111111111
        1222222221111111111111101
        1200N00001110000001000001
        1200000222000020001000001
111111111011000001110000000000201
100000000011000001110110111111111
11111101111111011100000000001
11110000111111011101010010001
11000000110101011100000010001
1000000000000000110000001000111
1000000000000000000101010000001
1100000111010101111101000000111
100000000011000001110110111111111
11111101111111011100000000001
11110000111111011101010010001
11000000110101011100000010001
1000000000000000110000001000111
1000000000000000000101010000001
1100000111010101111101000000111
11110111 1110101 101111000011
   111     1111111111111111111111